100, 100, 0,1,0,1,1,1,0,0,0,0,0,0
200,  60, 1,0,1,0,0,1,1,0,0,0,0,0
320, 100, 0,1,0,0,0,0,1,1,0,0,0,0
 40, 140, 1,0,0,0,1,0,0,0,1,0,0,0
170, 160, 1,0,0,1,0,1,0,0,1,1,0,1
220, 170, 1,1,0,0,1,0,1,0,0,0,1,1
300, 180, 0,1,1,0,0,1,0,0,0,0,1,0
420, 200, 0,0,1,0,0,0,0,0,0,0,1,0
100, 230, 0,0,0,1,1,0,0,0,0,0,0,1
160, 220, 0,0,0,0,1,0,0,0,0,0,0,1
340, 260, 0,0,0,0,0,1,1,1,0,0,0,1
220, 280, 0,0,0,0,1,1,0,0,1,1,1,0