 80,  60, 0,1,1,0,0,0,0,0,0,0,0,0
200,  60, 1,0,1,1,0,0,0,0,0,0,0,0
140, 110, 1,1,0,1,0,0,0,0,0,0,0,0
266, 110, 0,1,0,0,1,0,1,1,0,0,0,0
368,  85, 0,0,0,1,0,0,0,1,0,0,0,0
 90, 200, 0,0,1,0,0,0,0,0,0,1,0,0
200, 185, 0,0,1,1,0,0,0,0,0,0,1,0
335, 170, 0,0,0,1,1,0,0,0,1,0,0,0
335, 230, 0,0,0,0,0,0,0,1,0,0,1,1
100, 275, 0,0,0,0,0,1,0,0,0,0,1,0
240, 300, 0,0,0,0,0,0,1,0,1,1,0,1
420, 315, 0,0,0,0,0,0,0,0,1,0,1,0