 30, 180, 0,1,0,0,0,0,1,0,0,0,0
100,  80, 1,0,1,0,1,0,0,0,0,0,0
370,  50, 0,1,0,0,0,1,0,0,0,0,1
110, 200, 0,0,0,0,1,0,1,1,0,0,0
140, 130, 0,1,0,1,0,1,0,1,0,0,0
230, 110, 0,0,1,0,1,0,0,1,1,0,0
150, 270, 1,0,0,1,0,0,0,1,0,0,1
200, 160, 0,0,0,1,1,1,1,0,0,1,0
310, 150, 0,0,0,0,0,1,0,0,0,1,1
240, 190, 0,0,0,0,0,0,0,1,1,0,1
350, 240, 0,0,1,0,0,0,1,0,1,1,0